696,696,696,696,696,696,696,762,696,696,696,696,696,696,696,696,696,696,696,696,696,696,696,696,696,696,696,696,696,696,696,696,696,696,696,696,696,696,696,696,696,696,696,696,696,696,696,696,696,696,696,696,696,696,696,696,696,696,696,696,696,696,696,696,696,696,696,696,696,696,696,696,696,696,696,696,696,696,696,696,696,696,696,696,696,696,696,696,696,696,696,696,696,696,696,696,696,696,696,696,696,696,696,696,696,696,696,696,696,696,696,696,696,696,696,696,696,696,696,696,696,696,696,696,696,696,696,696,696,696,696,696,696,696,696,696,696,696,696,696,696,696,696,696,696,696,696,696,696,696,696,696,696,696,696,696,696,696,696,696,696,696,696,696,696,696,696,696,696,696,696,696,696,696,696,696,696,696,696,696,696,696,696,696,696,696,696,696,696,696,696,696,696,696,696,696,696,696,696,696,696,696,696,696,696,696,696,696,696,696,696,696,696,696,696,696,696,696,696,696,696,696,696,696,696,696,696,696,696,696,696,696,696,696,696,696,696,696,696,696
696,696,660,661,662,762,762,762,762,762,762,762,762,697,696,696,696,696,696,660,661,662,696,696,696,696,696,696,696,696,696,696,696,696,696,696,660,661,661,662,696,696,696,696,696,696,696,696,696,696,696,696,696,696,696,696,696,696,696,696,696,696,696,696,696,696,696,660,661,662,696,696,696,696,696,696,696,696,696,696,696,696,696,696,696,660,661,661,662,696,696,696,696,696,696,696,696,696,696,696,696,696,696,696,696,696,696,696,696,696,696,696,696,696,696,696,660,661,662,696,696,696,696,696,696,696,696,696,696,696,696,696,696,660,661,661,662,696,696,696,696,696,696,696,696,696,696,696,696,696,696,696,696,696,696,696,696,696,696,696,696,696,696,696,660,661,662,696,696,696,696,696,696,696,696,696,696,696,696,696,696,660,661,661,662,696,696,696,696,696,696,696,696,696,696,696,696,696,696,280,696,696,696,696,696,696,696,696,696,696,696,696,696,696,696,696,696,696,696,696,696,696,696,696,696,696,696,696,696,696,696,696,696,696,696,696,696,696,696,696
696,696,693,694,695,762,762,762,762,762,696,762,696,696,762,696,696,696,696,693,694,695,696,696,696,696,696,660,661,661,661,662,696,696,696,696,693,694,694,695,696,696,696,696,696,696,696,696,696,696,696,696,696,696,696,696,660,661,662,696,696,696,696,696,696,696,696,693,694,695,696,696,696,696,696,696,660,661,661,661,662,696,696,696,696,693,694,694,695,696,696,696,696,696,696,696,696,696,696,696,696,696,696,696,696,660,661,662,696,696,696,696,696,696,696,696,693,694,695,696,696,696,696,696,660,661,661,661,662,696,696,696,696,693,694,694,695,696,696,696,696,696,696,696,696,696,696,696,696,696,696,696,696,660,661,662,696,696,696,696,696,696,696,696,693,694,695,696,696,696,696,696,660,661,661,661,662,696,696,696,696,693,694,694,695,696,696,696,696,696,696,696,696,696,696,696,696,696,696,313,696,660,661,662,696,696,696,696,696,696,696,696,696,696,696,696,696,696,696,696,696,696,696,696,696,696,696,696,696,696,696,696,696,696,696,696,696,696,696,696
696,696,762,762,762,762,762,762,762,762,762,762,762,696,762,696,696,696,696,696,696,762,696,696,696,696,696,693,694,694,694,695,696,696,696,696,696,696,696,696,696,696,696,696,696,696,696,696,696,696,696,696,696,696,696,696,693,694,695,696,696,696,696,696,696,696,696,696,696,696,696,696,696,696,696,696,693,694,694,694,695,696,696,696,696,696,696,696,696,696,696,696,696,696,696,696,696,696,696,696,696,696,696,696,696,693,694,695,696,696,696,696,696,696,696,696,696,696,696,696,696,696,696,696,693,694,694,694,695,696,696,696,696,696,696,696,696,696,696,696,696,696,696,696,696,696,696,696,696,696,696,696,696,693,694,695,696,696,696,696,696,696,696,696,696,696,696,696,696,696,696,696,693,694,694,694,695,696,696,696,696,696,696,696,696,696,696,696,696,696,696,696,696,696,696,696,696,696,696,313,696,693,694,695,696,696,696,696,696,696,696,696,696,696,696,696,696,696,696,696,696,696,696,696,696,696,696,696,696,696,696,696,696,696,696,696,696,696,696,696
696,696,762,762,762,762,762,762,1,24,1,762,762,762,762,696,762,696,762,696,696,762,24,696,696,696,696,696,696,696,696,696,696,696,696,696,696,696,696,696,696,696,696,696,696,696,696,696,696,696,696,696,696,696,696,696,696,696,696,696,696,696,696,696,696,696,696,696,696,696,696,696,696,696,696,696,696,696,696,696,696,1,1,1,1,1,1,1,1,696,696,696,1,1,1,24,696,696,696,696,696,696,696,696,696,696,696,696,696,696,24,696,696,696,696,696,696,696,696,696,696,696,1,1,1,696,696,696,696,1,24,24,1,696,696,696,696,696,696,696,696,696,696,696,696,696,696,696,696,696,696,696,696,696,696,696,696,696,696,696,696,696,696,696,696,696,696,696,696,696,696,696,696,696,696,696,696,696,696,696,696,696,696,696,696,696,696,696,696,33,33,696,696,696,696,696,696,696,696,313,696,696,696,696,696,696,696,696,696,696,696,696,696,696,696,696,696,696,696,696,696,696,696,696,696,696,696,696,696,696,696,696,696,696,696,696,696,696,696,696
696,1,24,762,762,762,762,762,762,762,762,762,762,762,762,696,696,696,696,696,696,762,696,696,696,696,696,696,696,696,696,696,696,696,696,696,696,696,696,696,696,696,696,696,696,696,696,696,696,696,696,696,696,696,696,696,696,696,696,696,696,696,696,696,696,696,696,696,696,696,696,696,696,696,696,696,696,696,696,696,696,696,696,696,696,696,696,696,696,696,696,696,696,696,696,696,696,696,696,696,696,696,696,696,696,696,696,696,696,696,696,696,696,696,696,696,696,696,696,696,696,696,696,696,696,696,696,696,696,696,696,696,696,696,696,696,696,696,696,696,696,696,696,696,696,696,696,696,696,696,696,696,696,696,696,696,696,696,696,696,696,696,696,696,696,696,696,696,696,696,696,696,696,696,696,696,696,696,696,696,696,696,696,696,696,696,696,696,33,33,33,696,696,696,696,696,696,696,696,313,696,696,696,696,696,696,696,696,696,696,696,696,696,696,696,696,696,696,696,696,696,696,696,696,696,696,696,696,696,696,696,696,696,696,696,696,696,696,696,696
696,696,762,696,762,762,762,762,762,762,762,762,696,762,762,696,762,696,762,762,762,762,696,696,696,696,696,696,696,696,696,696,696,696,696,696,696,696,696,696,696,696,696,696,696,696,696,696,696,696,696,696,696,696,696,696,696,696,696,696,696,696,696,696,696,696,696,696,696,696,696,696,696,696,696,696,696,696,696,696,696,696,696,696,696,696,696,696,696,696,696,696,696,696,696,696,696,696,696,696,696,696,696,696,696,696,696,696,696,696,696,696,696,696,696,696,696,696,696,696,696,696,696,696,696,696,696,696,696,696,696,696,696,696,696,696,696,696,696,696,696,696,696,696,696,696,696,696,696,696,696,696,696,696,696,696,696,696,696,696,696,696,696,696,696,696,696,696,696,696,696,696,696,696,696,696,696,696,696,696,696,696,696,696,696,696,696,33,33,33,33,696,696,696,696,696,696,696,696,313,696,696,696,696,696,696,696,696,696,696,696,696,696,696,696,696,696,696,696,696,696,696,696,696,696,696,696,696,696,696,696,696,696,696,696,696,696,696,696,696
696,696,696,696,696,696,696,696,696,696,696,696,696,696,696,696,696,696,696,696,696,696,696,696,696,696,696,696,696,696,696,696,696,696,696,696,696,696,696,696,696,696,696,696,696,696,696,696,696,696,696,696,696,696,696,696,696,696,696,696,696,696,696,696,696,696,696,696,696,696,696,696,696,696,696,696,696,696,696,696,696,696,696,696,696,696,696,696,696,696,696,696,696,696,696,696,696,696,696,696,696,696,696,696,696,696,696,696,696,696,696,696,696,696,696,696,696,696,696,696,696,696,696,696,696,696,696,696,696,696,696,696,696,696,696,696,696,696,696,696,696,696,696,696,696,696,696,696,696,696,696,696,696,696,696,696,696,696,696,696,696,696,696,696,696,696,696,696,696,696,696,696,696,696,696,696,696,696,696,696,696,696,696,696,696,696,33,33,33,33,33,696,696,696,696,696,696,696,696,313,696,696,696,696,696,11,11,11,696,696,696,696,696,696,696,696,696,696,696,696,696,696,696,696,696,696,696,696,696,696,696,696,696,696,696,696,696,696,696,696
696,1,1,1,1,696,696,696,696,696,696,696,696,696,696,1,24,696,696,696,1,24,1,24,1,696,696,696,696,696,696,696,696,696,696,696,696,696,696,696,696,696,696,696,696,696,264,265,-1,696,696,696,696,696,696,696,696,264,265,-1,696,696,696,696,696,696,696,696,696,696,696,696,696,696,696,696,696,696,1,24,1,696,696,696,696,696,696,696,696,696,696,696,696,696,696,1,696,696,696,696,696,1,1,696,696,696,696,24,696,696,24,696,696,24,696,696,696,696,696,1,696,696,696,696,696,696,696,696,696,696,1,1,696,696,696,696,696,696,33,696,696,33,696,696,696,696,696,696,696,696,696,696,33,33,696,696,33,696,696,696,696,696,696,696,696,696,696,696,696,1,1,24,1,696,696,696,696,696,696,696,696,696,696,696,696,33,33,33,33,33,33,696,696,696,696,696,696,696,696,313,696,696,696,696,696,12,13,14,696,696,696,696,696,696,696,696,696,696,696,696,696,696,696,264,265,696,696,696,696,696,696,696,696,696,696,696,696,696,696,696
696,696,696,696,696,696,696,696,696,696,696,696,696,696,696,696,696,696,696,696,696,696,696,696,696,696,696,696,696,696,696,696,696,696,696,696,762,672,264,265,696,696,696,696,696,696,297,298,-1,696,273,696,696,696,696,696,696,297,298,-1,696,696,696,696,696,696,696,696,696,696,696,696,696,696,696,696,696,696,696,696,696,696,696,696,696,696,696,696,696,696,696,696,696,696,696,696,696,696,696,273,696,696,696,696,696,696,696,696,696,696,696,696,696,696,696,696,696,696,696,696,696,696,696,696,696,696,696,696,696,696,696,696,696,696,696,696,696,33,33,696,696,33,33,696,696,696,696,273,696,696,696,33,33,33,696,696,33,33,696,696,696,696,696,696,696,696,696,696,696,696,696,696,696,696,696,696,696,696,696,696,696,696,696,696,33,33,33,33,33,33,33,696,696,696,696,273,696,696,696,313,696,696,696,696,11,44,44,44,11,696,696,696,696,696,696,696,696,696,696,696,696,696,696,297,298,696,696,696,696,696,696,696,696,696,696,696,696,696,696,696
696,696,696,696,696,696,696,696,696,696,696,696,696,696,696,696,696,273,696,696,696,696,696,696,696,696,696,696,264,265,696,696,696,696,696,696,696,696,297,298,696,696,696,696,696,696,297,298,-1,272,305,274,696,696,696,696,696,297,298,-1,696,696,696,696,696,273,696,696,696,696,696,696,696,696,696,696,696,696,696,696,696,696,696,696,696,696,696,696,696,696,696,696,696,696,696,696,696,696,272,305,274,696,696,696,696,696,696,696,696,696,696,696,696,696,273,696,696,696,696,696,696,696,696,696,696,696,696,696,696,696,696,696,696,696,696,696,33,33,33,696,696,33,33,33,696,696,272,305,274,696,33,33,33,33,696,696,33,33,33,696,696,696,273,696,264,265,696,696,696,696,696,696,696,696,696,696,696,696,696,696,264,265,696,33,33,33,33,33,33,33,33,696,696,696,272,305,274,696,696,313,696,696,696,696,13,13,45,13,13,696,696,273,696,696,696,696,696,696,696,696,696,266,267,268,298,696,696,696,696,696,696,696,696,696,696,696,696,696,696,696
696,696,696,696,696,696,696,696,696,696,696,308,309,309,309,310,272,305,274,696,696,696,696,308,309,310,696,696,297,298,696,696,696,696,696,696,696,696,297,298,696,308,309,309,310,762,297,298,272,305,306,305,274,696,696,696,696,297,298,308,309,309,309,310,272,305,274,696,696,696,696,308,309,310,696,696,696,696,696,696,696,696,696,696,696,696,696,696,696,696,308,309,309,310,696,696,696,272,305,306,305,274,696,696,696,696,696,696,308,309,309,309,310,272,305,274,696,696,696,696,308,309,310,696,696,696,696,696,696,696,696,696,696,696,696,33,33,33,33,309,309,33,33,33,33,272,305,306,305,33,33,33,33,33,696,696,33,33,33,33,310,272,305,274,297,298,696,696,308,309,310,696,696,696,696,696,696,696,696,696,297,298,33,33,33,33,33,33,33,33,33,696,696,272,305,306,307,274,696,33,696,696,696,696,13,13,46,13,13,376,272,305,274,696,696,696,696,696,696,696,696,299,300,301,298,696,696,696,696,696,696,696,696,696,696,696,696,696,696,696
0,0,0,0,0,0,0,0,0,0,0,0,0,0,0,0,0,0,0,0,0,0,0,0,0,0,0,0,0,0,0,0,0,0,0,0,0,0,0,0,0,0,0,0,0,0,0,0,0,0,0,0,0,0,0,0,0,0,0,0,0,0,0,0,0,0,0,0,0,696,696,0,0,0,0,0,0,0,0,0,0,0,0,0,0,0,0,696,696,696,0,0,0,0,0,0,0,0,0,0,0,0,0,0,0,0,0,0,0,0,0,0,0,0,0,0,0,0,0,0,0,0,0,0,0,0,0,0,0,0,0,0,0,0,0,0,0,0,0,0,0,0,0,0,0,0,0,0,0,0,0,0,0,0,696,696,0,0,0,0,0,0,0,0,0,0,0,0,0,0,0,0,0,0,0,0,0,0,0,0,0,0,0,0,0,0,0,0,0,0,0,0,0,0,0,0,0,0,0,0,0,0,0,0,0,0,0,0,0,0,0,0,0,0,0,0,0,0,0,0,0,0,0,0,0,0,0,0,0,0,0,0,0,0,0,0,0,0,0,0
